111111111111
1P0000EC0001
111111111111