111111111111
1P0000100001
10C001E10001
100000100001
111111111111