111111111111111111111
10P001C000000000000E1
100001111100000000111
100001000000000000001
1000010000000000C0001
100001111111111000001
10000000001C000000001
100000000C10000000001
100000000011111110001
10011111111C000000001
100000000C10000000001
100000000010000000001
100000000011111111001
100000000000000000001
111111111111111111111